000000000000000000000000000000
000100011100000000000000000000
001101111110000000000000000000
011111111111100000000000000000
011111111111111000000000000001
111111111111111000000000000111
111111001111100000000000000111
111000001111000000000000011111
110000000000000000000011111111
000000000000000000001111111111
000000000000000000000111011111
000000000000000000000110001110
000001111100000000000100000100
000011111000000000000000000000
000011100000000000000000000000
000111100000000000000000000000
000111000000000000000000000000
000110000000000000000000000000
000100000000000000000000000000
000000000000000000000000000000
