11111111000000000000000000000011111111111111111111
11111111100000000000001111100001111111111121111111
11111111100000000000011121100000111111111111111111
11111211110000000000021111110000001111111111111111
11111111110000000000001111100000111111111103000111
11111111110000000000000000000000111111110000000111
11111111000000000000000000000011111111100000000111
11111111110000000011111110000011111111000000000111
11111111100000001111111111000000111111000000001111
11111110000000011111111100000000021100000000011111
11111110000000011111211100000000011000000001111111
11111111000000111111111110000000000000000001111111
11111110000000011111111100000000000000000011111111
11111111100000000111120000000000000000001111111111
11111111111200000000000000000000000000011111111111
11141111111110000000000000000003000001111111111111
11111111111111110000000000000000000001111111111111
11111111111111100000000000000000000001111111211111
11111111111110000000000000000000000000011111111111
11111111100000000000000000000000000002111111111111
11111110000000000000000000000000000001111111111111
11110000000000000000000000000000000011111111111111
00000000000000000000011111111000000000111111111111
00000001111000000000111111110000000000011111111111
00000011111100000001111111111000000000011111111111
00011111111112000011111111111100000000111111111111
00111111111111111111111111111111000001111111111111
11111111111111111111111141111110000000011111111111
11111111111111111111111111110000000011111111111111
11111141111111111111111111000000001111111111111111
11111111111111111111111100000000001111111111111111
11111111111111121111111100000000000011111111111111
11111111111111111111111111000000000001111111211111
11111111111111111111111111110000000001111111111111
11111111111111111111111111111100000000011111111111
11111111111111111111111111111110000000001111111111
11111111100000000000111111111200000000000111111111
00001111100000000000001111100000000000000000001111
00000000000000000000000000000000000000000000000000
00000000000000000000000000000000000000000000000000